LLLLLLLHHLLLLLLL
LHLHLHLHHLLHLHLL
LLLLLLLHHLLLLLLL
HHHHHHHHHHHHHHHH
HHHHHHHHHHHHHHHH
HHHHHHHHHHHHHHHH
HHHHHHHHHHHHHHHH
HHHHHHHHHHHHHHHH
HHHHHHHHHHHHHHHH
LLLLLLLHHLLLLLLL
LLHLHLLHHLHLHLHL
LLLLLLLHHLLLLLLL
5,5,1,FC
10,5,1,FC
