LLLLLLLLLLLLLLLL
LLLLLLLHHLLLLLLL
LLLLLLLHHLLLLLLL
LHHHHHHHHHHHHHHH
LHHHHHHHHHHHHHHH
LMMMMMMMMMMMMMMM
LMMMMMMMMMMMMMMM
LHHHMMHHHHHHHHHH
LHHHMMHHHHHHHHHH
LLLLLLLHHLLLLLLL
LLLLLLLHHLLLLLLL
LLLLLLLHHLLLLLLL
