LLLLLLLLLLLLLLLL
LHHHHHHHHHHHHHHL
LHHHHHHHHHHHHHHL
LHHHHHHHHHHHHHHL
LHHHHHHHHHHHHHHL
LHHHHOHHHHOHHHHH
LHHHHHHHHHHHHHHL
LHHHHHHHHHHHHHHL
LHHHHHHHHHHHHHHL
LHHHHHHHHHHHHHHL
LHHHHHHHHHHHHHHL
LLLLLLLLHLLLLLLL
15,5,1,FD
