LLLLLLLHHLLLLLLL
LLLLLLLHHLLLLLLL
LLLLLLLHHLLLLLLL
HHHHHHHHHHHHHHHL
HHHHHHHHHHHHHHHL
HHHHHOHHHHOHHHHL
HHHHHHHHHHHHHHHH
HHHHHHHHHHHHHHHL
HHHHHHHHHHHHHHHL
LLLLLLLHHLLLLLLL
LLLLLLLHHLLLLLLL
LLLLLLLHHLLLLLLL
