LLLLLLLHHLLLLLLL
LLLLLLLHHLLLLLLL
LLLLLLLHHLLLLLLL
HHHHHHHHHHHHHHHH
HHHHHHHHHHHHHHHH
MMMMMMMMMMMMMMMM
MMMMMMMMMMMMMMMM
HHHHHHHHHHHHHHHH
HHHHHHHHHHHHHHHH
LLLLLLLHHLLLLLLL
LLLLLLLHHLLLLLLL
LLLLLLLHHLLLLLLL
