LLLLLLLLLLLLLLLL
LHHHHHHHHHHHHHHL
LHNNHHHHNNHHHHHL
LHNNHHHHNNHHHHHL
LHHHHHHHHHHHHHHL
HHHHHHNHHHHHHHHH
LHHNHHHHHHHHHHHL
LHNNHHHHHHNHHHHL
LHHNHHHHNNNHHHHL
LHHHNNNNNHHHHHHL
LHHHHHHHHHHHHHHL
LLLLLLLLLLLLLLLL
15,5,1,FE
5,5,1,FC
10,5,1,FC
0,5,1,FD
4,3,2,S30
4,7,2,S30
7,5,2,S26
4,5,2,S30
*15,5,AE
*10,5,AE
