LLLLLLLLHLLLLLLL
LHHHHHHHHHHHHHHL
LHHHHHHHHHHHHHHL
LHHHHHHHHHHHHHHL
LHHHHHHHHHHHHHHL
LHHHHOOHHHOOHHHH
LHHHHOOHHHOOHHHL
LHHHHHHHHHHHHHHL
LHHHHHHHHHHHHHHL
LHHHHHHHHHHHHHHL
LHHHHHHHHHHHHHHL
LLLLLLLLLLLLLLLL
8,0,1,FE
15,5,1,FD
*8,0,AD
