LLLLLLLHHLLLLLLL
LLLLLLLHHLLLLLLL
LLLLLLLHHLLLLLLL
HHHHHHHHHHHHHHHH
HHHHHHHHHHHHHHHH
MMHHHOHHHHOHHHHH
MMHHHHHHHHHHHHHH
HHHHHHHHHHHHHHHH
HHHHHHHHHHHHHHHH
LLLLLLLHHLLLLLLL
LLLLLLLHHLLLLLLL
LLLLLLLHHLLLLLLL
