LLLLLLLLLLLLLLLL
LHHHHHHHHHHHHHHL
LHHHHHHHHHHHHHHL
LHHHHHHHHHHHHHHL
LHHHHHHHHHHHHHHL
HHHHHHHHHHHHHHHL
LHHHHHHHHHHHHHHL
LHHHHHHHHHHHHHHL
LHHHHHHHHHHHHHHL
LHHHHHHHHHHHHHHL
LHHHHHHHHHHHHHHL
LLLLLLLLLLLLLLLL
7,9,1,FB
0,5,1,FD
