LLLLLLLLLLLLLLLL
LHHHHHHHHHHHHHHL
LHHHHHHHHHHHHHHL
LHHHHHHHHHHHHHHL
LHHHHHHHHHHHHHHL
HHHHHHHHHHHHHHHH
LHHHHHHHHHHHHHHL
LHHHHHHHHHHHHHHL
LHHHHHHHHHHHHHHL
LHHHHHHHHHHHHHHL
LHHHHHHHHHHHHHHL
LLLLLLLLLLLLLLLL
15,5,1,FE
5,5,1,FC
10,5,1,FC
*15,5,AE
*10,5,AE
