LLLLLLLLLLLLLLLL
LOOOOOOOOHHHHOOL
LOOOOOOHHHHHHOOL
LOOOOHHHHHHHHOOL
LOOHHHHHHHHHHHOL
LOHHHHNHHHNHHHHH
LHHHHHHNNHHHHHHL
LOHHHHHHHHHHHHHL
LOHHHHNHHNHHHOOL
LOOHHHHHHHHHHOOL
LOOOOHHHHHHOOOOL
LLLLLLLLHLLLLLLL
15,5,1,FD
12,6,1,FC
3,6,1,FC
11,2,1,IE
10,2,1,IE
6,5,2,S30
10,5,2,S30
6,8,2,S30
9,8,2,S30
8,6,2,S30
*11,2,AD
*12,6,AE
*10,2,AE
