LLLLLLLNNLLLLLLL
LLLLLLLNNLLLLLLL
LLLLLLLNNLLLLLLL
NNNNNNNNNNNNNNNN
NNNNNNNNNNNNNNNN
NNNOOONNNNOOONNN
NNNOOONNNNOOONNN
NNNOOONNNNOOONNN
NNNNNNNNNNNNNNNN
LLLLLLLNNLLLLLLL
LLLLLLLNNLLLLLLL
LLLLLLLNNLLLLLLL
