LLLLLLLHHLLLLLLL
LLLLLLLHHLLLLLLL
LLLLLLLHHLLLLLLL
LLLHHHHHHHHHHHHH
LLHHHHHHHHHHHHHH
LLLLLLHHHHHHHHHH
LLLLLLHHHHHHHHHH
LLHHHHHHHHHHHHHH
LLLHHHHHHHHHHHHH
LLLLLLLHHLLLHLLL
LLLLLLLHHLLLLLLL
LLLLLLLHHLLLLLLL
10,5,1,FC
