LLLLLLLLLLLLLLLL
LLLLLLLLLLLHHLLL
LLLHHHHLHLHHHLLL
LHHHHHHHHHHHHHLL
LHHHOOOHHOOOHHHL
LHHHOHOHHOHOHHHL
HHHHOOOHHOOOHHHL
LHHHHHHHHHHHHHLL
LHHHHHHHHHHHHHLL
LLHHHLLHHLLLHHLL
LLHHLLLLHLLLLLLL
LLLLLLLLHLLLLLLL
10,5,1,FC
5,5,1,IF
8,11,1,FD
0,6,1,FD
2,4,2,S26
2,7,2,S26
7,5,2,S30
3,5,2,S27
3,6,2,S27
8,5,2,S30
13,5,2,S27
