LLLLLLLLHLLLLLLL
LHHHHHHHHHHHHHHL
LHHHHHHHHHHHHHHL
LHHHHHHHHHHHHHHL
LHHHHHHHHHHHHHHL
LHHHHOHHHHOHHHHH
LHHHHHHHHHHHHHHL
LHHHHHHHHHHHHHHL
LHHHHHHHHHHHHHHL
LHHHHHHHHHHHHHHL
LHHHHHHHHHHHHHHL
LLLLLLLLHLLLLLLL
8,11,1,FD
15,5,1,FD
8,0,1,FE
