LLLLLLLLLLLLLLLL
LLLHHHHHHHHHHLLL
LLHHHHHHHHHHHHLL
LLHHHHOHHOHHHHHL
LHHHHHOHOHHHHHHL
LHHHHHOOHHHHHHHL
LHHHHHOOHHHHHHHL
LHHHHHOHOHHHHHHL
LLHHHHOHHOHHHHLL
LLLHHHHHHHHHHHLL
LLLLHHHHHHHLLLLL
LLLLLLLLHLLLLLLL
10,5,1,FC
4,5,1,FC
9,4,1,IL
8,11,1,FD
3,6,2,S27
11,6,2,S27
7,7,2,S27
4,2,2,S26
11,2,2,S26
*9,4,AD
