LLLLLLLLLLLLLLLL
LHHHHHHHHHHHHHHL
LHHONNNNHNNNNOHL
LHHHHHHHHHHHHHHL
LHNHOOOHHOOOHNHL
HHNHOHOHHOHOHNNL
LHNHOOOHHOOOHHNL
LHNNHHHHHHHHHHHL
LHHHOOHHHHHOOHHL
LHHHHOOHHHOOHHHL
LHHHHHOOOOOHHHHL
LLLLLLLLLLLLLLLL
0,5,1,FD
8,8,1,FB
5,2,2,S30
11,2,2,S30
10,2,2,S30
6,2,2,S30
