LLLLLLLLHLLLLLLL
LLLOOOLLHLLLOLLL
LLLOOOLLHLLLOOOL
LLLLLLHHHHHHLLOL
LLHHHHHNNHHNLHLL
HHHHOHHNNNNHHHHH
LHHHOHHNNHHHOHHL
LLLHHHHHNNHHLLHL
LLLLLHHHNHHHLLOL
LLLLLLLLHLLLLOOL
LLLLLLLLHLOOOOLL
LLLLLLLLHLLLLLLL
8,11,1,FE
5,6,1,FC
15,5,1,FD
8,0,1,FD
0,5,1,FD
7,5,2,S26
9,5,2,S26
8,7,2,S26
8,6,2,S26
8,5,2,S30
8,1,2,S26
