LLLLLLLLHLLLLLLL
LHHHHHHHHHHHHHHL
LHHHHHHHHHHHHHHL
LHHHHHHHHHOOOHHL
LHNHHOOOHHHHOHHL
LHNHHOHOHHOHOHHH
LHNHHOOOHHOHOHHL
LHNNHOOOHHOHOHHL
LHHHHOHOHHOOOHHL
LHHHHOOOHHHHHHHL
LHHHHHHHHHHHHHHL
LLLLLLLLLLLLLLLL
8,0,1,FE
15,5,1,FD
6,8,1,IF
6,5,1,IO
11,6,1,FC
13,3,2,S30
7,3,2,S30
8,3,2,S30
2,3,2,S30
6,7,2,S30
*8,0,AD
