LLLLLLLNNLLLLLLL
LLLLLLLNNLLLLLLL
LLLLLLLNNLLLLLLL
NNNNNNNNNNNNNNNN
NNNNNNNNNNNNNNNN
NNNONONNNNONONNN
NNNNNNNNNNNNNNNN
NNNONONNNNONONNN
NNNNNNNNNNNNNNNN
LLLLLLLNNLLLLLLL
LLLLLLLNNLLLLLLL
LLLLLLLNNLLLLLLL
