IIIIIIIIIIIIIIII
IOIIKNKNONKNKIOI
IIIIIIIIIIIIIIII
IKNNNNNNNNNNNNNI
INNKNKNKNKNKNKNI
INKNKOOOOOOOKNKI
INNKNOOOHOOONKNK
INKNKNKNKNKNKNKI
IKNNNNNNNNNNNNNI
IIIIIIIIIIIIIIII
IOIIKNKNONKNKIOI
IIIIIIIIIIIIIIII
15,6,1,FD
8,6,1,FB
1,8,2,S26
1,3,2,S26
1,5,2,S26
1,6,2,S26
1,7,2,S26
1,4,2,S26
