CCCCCCCCCCCCCCCC
CCCCCAAAAAAAAAAA
CCCCCAABBBBBBBBB
CCCCCAABBBBBBBBB
CAAAAAABBBAAAAAA
CAAAAAAGGAAAAAAA
CAAAAAABBAAAAADD
CAAAAAABBAAAAADD
CAAAAABBBBAAAADD
CAAAABBBBBBAAADD
CEEAABBBBBBAADDD
CEEAAABBBBAADDDD
4,6,1,FF
2,5,1,FF
3,8,1,FF
