AAAAAAADDDDDDDDD
AAAAAADDDDDDDDDD
AAAAADDDDDDDDDDD
AAADDDDDDDDCDDDD
ADDDDDDDDDDDDDDD
DDDDDDDDDDDDFDDD
DDDDDDDCDDDDDDDD
DDFDDDDDDDDDDDDD
DDDDDDDFDDDDDDDD
DDDCDDDDDDDCDDDD
DDDDDDDDDDDDDDDD
CCCCCCCCCCCCCCCC
3,1,1,FF
1,2,1,FF
9,5,1,IM
4,7,1,FG
4,9,2,S24
8,3,2,S24
13,7,2,S24
10,7,2,S24
5,5,2,S24
2,2,2,S19
*9,5,AE
*4,7,AE
