DADADDEEEEEEEDDC
AADADDEEEEEEEDDC
DAADADEEEEEEDDDC
DADDDEEEEEEDDCDC
DDEEEEEEEEDDDDDC
DEEEEEEEEDDDFDDC
EEEEEEEEDDDDDDDC
EEEEEEEDDDDDDDDC
EEEEEEDDCDDDDDDC
EEEEDDDDDDDDCDDC
DDDDDDFDDDDDDDDC
CCCCCCCCCCCCCCCC
2,2,1,FA
4,10,1,FG
8,2,2,S14
6,4,2,S14
2,6,2,S14
11,6,2,S21
10,9,2,S21
3,1,2,S19
1,2,2,S19
*10,9,AE
*4,10,AE
@2,2,AH
