AAABBBBBBGGGBBBB
AAABBBBBBGGGBBBB
AABBBBBBBGGGBBBB
ABBBBBBBGGGGBAAA
ABBBBBBBBGGAAAAA
BBBBBBBBBAAAAAAA
BBBBBBBBAAAAAAAA
BBBBBBBAAAAAAAAA
BBBBBBAAAAAAAAAA
BBBBBAAAAAAAAAAA
BBBBBAAAAAAAAAAA
BBBBBAAAAAAAAAAA
