CCCCCEEAAAAEEEEA
CCEECAEEEAAAAAAA
ECCCEAABBEEBEBBB
ECCCEAABBEBBBBBB
EAAEEEEEEEAAAAAA
AAEAEEEEEEEEEEAE
EAAAEEABBAEEEEED
EAAEAAABBAEEAEDE
AAAEAABBBBEEEADD
EAAEEBBBBEEEEADD
EEEAAEBEBBEAADDE
EEEEEAEEBEEAEEED
4,6,1,FF
2,5,1,FF
3,8,1,FF
