EEEEEEGEEEEEEEEC
EEEEEEGEGGGEEEEC
EEEEEEEEEEEGEEEC
EEEEEEEEEEEGEEEC
GGEGEEEEEEEEEEEC
EEEGEGEEEEEGEEEC
EEEEEGEGGEEGEEEC
EEEEEEEEEEEEEEEC
EEEEEEEEGEEGEEEC
EEEEEEEEGEEGEEEC
CCEEEEEEEGGECCCC
CCCCCCCCCCCCCCCC
*2,4,AA
*4,5,AA
*6,6,AA
*8,7,AA
*8,10,AA
*11,10,AA
*11,7,AA
*11,4,AA
*11,1,AA
*7,1,AA
