AAAAAAAAAAAAAAAA
AAAAAAAAAAAAAAAA
AAAAAAAAAAAAAAAA
AAAAAAAAAAAAAAAA
AAAAAAAAAAAAAAAA
AAAAAAAAAAAAAAAD
AAAAAAAAAAAAAADD
AAAAAAAAAAAAAADD
AAAAAAAAAAAAAADD
AAAAAAAAAAAAAADD
AAAAAAAAAAAAADDD
AAAAAAAAAAAADDDD
10,4,1,FF
5,5,1,FF
9,9,1,FF
8,6,1,FH
6,2,1,IG
3,8,1,FF
12,2,1,FF
6,5,2,S19
11,4,2,S19
10,9,2,S19
*6,2,AD
