CAAAAAAAAAAAAAAA
CAAAAAAAAAAAAAAA
CAAAAAAAAAAAAAAA
CAAAAAAAAAAAAAAA
CAAAAAAAAAAAAAAA
CAAAAAAAAAAAAAAA
CAAAAACCAAAAAAAA
CAAAACCCCAAAAAAA
CAAAAACCAAAAAAAA
CAAAAAAAAAAAAAAA
CFFAAFFAAFFAAFFA
CFFFFFFFFFFFFFFF
11,4,1,FF
12,3,1,FF
13,4,1,FF
12,4,1,IF
12,5,1,FF
4,3,2,S11
13,9,2,S11
3,8,2,S11
9,2,2,S11
10,10,2,S29
8,5,2,S29
2,5,2,S29
*13,4,AC
