CCCAAAAAAEEEEEAA
CCCAAAAAEEEEEEAA
FCAAAAAAAEEEEEEA
CAAAAAAAAAEEEECA
AAAAAAAAAEEEEAAA
AAAAAAAAEEEEAAAA
AAAAAAAAAAAAAAAA
AAAAAAAAAAAAAAAA
AAAAAAAAAAAAAAAA
AAAAAAAAAAAAAAAA
AAAAAAAAAAAAAAAA
AAAAAAAAAAAAAAAA
