CBBBBBBGGBBBBBBB
BBBBBBBGGBBBBBBB
BBBBBBBGGGBBBBBB
BBBBBBBGGGBBBBBB
BGGGGGGGGGGBBBBB
GGGGGGGGGGGGBBBB
BBGGGGGGGGGGGAAB
BBBBBBBBBBAAAAAA
BBBBBBBBBAAAAACA
BBBBBBBBAAAAAAAA
BBBBBBBBAAAAAAAA
BBBBBBBAAAAAAAAA
13,10,2,S19
2,10,2,S13
4,1,2,S13
13,2,2,S13
6,4,2,S21
8,4,2,S21
6,6,2,S21
8,6,2,S21
