BBBBBBBAAAAAAAAA
BBBBBAAAAAAAAAAA
FAAAAAAAAAAAAAAA
FAAAAAAAAAAAAAAA
FAAAAAAAAAAAAAAA
FAAAAAAAAAAAAAAA
FCCCCCCCCCCCCCCC
FCCCCCCCFFFCCCCC
FCCCCCCCFFCCCCCC
FCCFFCCFFCCCCCCC
FCCFFFFFCCCCCCCC
FCCCFFFCCCCCCCCC
7,2,1,FF
9,3,1,FF
7,5,1,FF
5,10,1,IF
6,10,1,IF
9,7,2,S21
3,9,2,S21
3,3,2,S19
5,3,2,S19
11,3,2,S19
13,3,2,S19
*5,10,AD
*6,10,AD
