CCCCCCCCCCCCCCCC
BBBBBBBBBBBBBBBB
BBBBBBBBBBBGBGGB
BBBBBBBBBBGGBBGB
BBBBBBBBBGBBBBGB
BBBBBBBBBGBBBBBB
GGGBBBBBBGBBBBGB
BBBBBBBBBBBBBBGG
BBGGGGBGGGBBBBBB
BBBEEBBBBBBEEEEE
BBEEEEEEEEEEEEEE
BEEEEEEEEEEEEEEE
12,10,2,S14
6,10,2,S14
8,3,2,S13
8,6,2,S13
12,3,2,S13
12,6,2,S13
*14,5,AA
*12,2,AA
*6,8,AA
*9,7,AA
*2,7,AA
*9,3,AA
