CCCCCAAAAAAAAAAA
CCCCCAAAAAAAAAAA
CCCCCAABBBBBBBBB
CCCCCAABBBBBBBBB
AAAAAAABBBAAAAAA
AAAFAAAGGAAAAAAA
AAFAFFABBAAAAADD
AAAFAAABBAAAAADD
AAAAAABBBBAAAADD
AAAAABBBBBBAAADD
EEAAABBBBBBAADDD
EEAAAABBBBAADDDD
4,6,1,FF
2,5,1,FF
3,8,1,FF
10,6,1,FG
13,6,1,FG
10,4,1,FG
13,4,1,FG
3,6,1,FG
