DDDDDDDDDDDDDDDC
DDCDDFDDCDDDDDDC
DDDDDDDDDDDFDCDC
EEEEEEEEDDDDDDDC
EEEEEEEEEDDDDFDC
EEEEEEEEEEEDDDDC
EEEEEEEEEEEEDDDC
EEEEEEEEEEEEEDDC
EEEEEEEEEEEEEEDC
EEEEEEEEEEEEEEDC
EEEEEEEEEEEEEEDC
DADADDEEEEEEEEDC
11,2,1,IA
3,6,2,S14
7,7,2,S14
9,9,2,S14
5,9,2,S14
2,4,2,S14
6,5,2,S14
10,3,2,S24
14,8,2,S24
*11,2,AD
