AAAAAAAAAAAAAAAA
AAAAAAAAAAAAAAAA
AAAAAAAAAAAAAAAA
AACAAAAAAAAAAAAA
AAAAAAAAAAACAAAA
AAAAAAAAAAAAAAAA
AAAAAAAAAAAAAAAD
AAAAAAAAAAAAAADD
AAAAAAAAAAAAAADD
AAAAAAAACAAAADFD
AAAAAAAAAAAADDDD
CCCCCCCCCCCCCCCC
7,4,1,FF
9,5,1,FF
8,6,1,FF
12,1,1,FF
3,5,1,FF
5,9,1,FF
8,5,1,IE
4,2,2,S19
13,3,2,S19
10,9,2,S19
5,7,2,S19
2,9,2,S19
9,2,2,S29
*8,5,AD
