AABBBBBBBBBBBBBA
AABBBBBBBBBBBBAA
AABBBBBBBBBBBBAA
AAABBBBBBBBBBAAA
AAABBBBBBBBBBAAA
AAAGGGGGGGGGGAAA
AAGGGGGGGGGGAAAA
ABBBBBBBBBBAAAAA
BBBBBBBBBBAAAAAA
BBBBBBBBBBAAAAAA
BBBBBBBBBBAAAAAA
BBBBBBBBBAAAAAAA
14,10,1,IF
8,1,2,S13
8,3,2,S13
7,8,2,S13
14,7,2,S29
11,10,2,S29
6,5,2,S19
