AAAAAAAAAAAAAAAA
AAAAAAAAAAAAAAAA
AAAAAAAAAAAAAAAA
AAAAAAABBBBBBBBA
CAAAAAABBBAAAAAA
CAAAAAAGGAAAAAAA
CAAAAAABBAAAAADD
CAAAAAABBAAAAADD
CAAAAABBBAAAAADA
CAAAABBBBAAAAADA
CAAAABBBBBBAAADA
CAAAAABBBBAAAAAA
