DDDDDDADDDAADDAA
DDDDDDDAAAAAADAA
DDDDDDABDBAADBBA
DCDDCADDBAABBDDA
DAAADDDBDDAAADDA
AAAADDDGGAADAADA
ADAADDDDBAADDADA
DADADDDDDAADAAAA
AAADDDDDDADDADAD
AAAADBDDBADDAAAA
EEAADBBBBDDDADDD
DEADAABBBBDDDDDD
4,6,1,FF
2,5,1,FF
3,8,1,FF
