GGGGGGGGGGGGGGGG
GGGGGGGGGGGGGGGG
GGGGGGGGGGGGGGGG
GGBBGGGGGGBBGGGG
GGBBGGGGGGBBGGGG
GGGGGGGGGGGGGGGG
GGGGGGFGGGGGGGGG
GGGGGGFFGGGGGCGG
GGEGGGGGGGGGGGGG
GGEGGGGGGGGEGGGG
GGEEEEEEEEEEGGGG
GGGGGGGGGGGGGGGG
