DCCCCDADDDAADDAA
DCCDDADAAAAAADAA
DCCCDAABDBBBDBBB
DCCCCAABBDBBBDDB
DAAADAABDDAAADDD
AAAADADGGDDDAADA
ADAADAABBADDDDDD
DADADADBBAADAADD
AAADDADBBDDDADDD
AAAADBBBBBDDAADD
EEAADBBBBDDDADDD
DEADAABBBBDDDDDD
4,6,1,FF
2,5,1,FF
3,8,1,FF
