AAAAAAAAAADDDDDD
AAAAAADDDDDDDDDD
AAADDDDDDDDDCDDD
AADDDDDDDFDDDDDE
ADDFDDDDDDDDDDEE
DDDDDDFDCDDDDEEE
DDDDDDDDDDDEEEEE
DDDDDDDDDDEEEEEE
DDCDDDDCDDEEEEEE
DDDDFDDDDDEEEEEE
DDDDDDDDDEEEEEEE
DDDDDDDDEEEEEEDD
1,1,1,FF
14,7,2,S14
12,9,2,S14
5,7,2,S24
11,4,2,S24
7,6,2,S21
