AAAAAAAAAAAACCFC
AAAAAAAAAAAAACFF
AAAAAAAAAAAAACCC
AAAAAAAAAAAAAACC
AAAAAAAAAAAAAAAA
AAAAAAAAAAAAAAAA
AAAAAAAAAAAAAAAA
AAAAAAAAAAAAAAAA
AAAAAAAAAAAAAAAA
AAAAAAAAAAAAAAAA
AAAAAAAAAAAAAAAA
AAACAAAAAAAAAAAA
5,4,1,FF
7,5,1,FF
5,7,1,FF
3,3,2,S19
10,3,2,S19
10,7,2,S19
3,7,2,S19
10,9,2,S21
