CCCCCAAAAAAAAAAA
CCCCCAAAAAAAAAAA
CCCCCAABBBBBBBBB
CCCCCAABBBBBBBBB
AAAAAAABBBAAAFAA
AAAAAAAGGAAAFFFA
AAAAAAABBAAFAFDF
AAAAAAABBAAAAFDD
AAAAAABBBBAAAFDD
AAAAABBBBBBAAFDD
EEAAABBBBBBAADDD
EEAAAABBBBAADDDD
4,6,1,FF
2,5,1,FF
3,8,1,FF
5,6,1,FF
6,6,1,FF
7,6,1,FF
8,6,1,FF
7,5,1,FF
6,4,1,FF
7,7,1,FF
6,8,1,FF
13,1,1,FG
