AAAAAAAAAAAACCCC
AAAAAAAAAAAAACFF
AAAAAAAAAAAAAFFC
AAAAAAAAAAAAAACC
AAAAAAAAAAAAAAAA
AAAAAAAAAAAAAAAA
AAAAAAAAAAAAAAAA
AAAAAAAAAAAAAAAA
AAAAAAAAAAAAAAAA
AAAAAAAAAAAAAAAA
AAAAAAAAAAAAAAAA
AAAAAAAAAAAAAAAA
