AAAAAAAAAAAACCCC
AAAAAAAAAAAAACFC
AAAAAAAAAAAAAFFC
AAAAAAAAAAAAAACC
AAAAAAAAAAAAAAAA
AAAAAAAAAAAAAAAA
AAAAAAAAAAAAAAAA
AAAAAAAAAAAAAAAA
AAAAAAAAAAAAAAAA
AAAAAAAAAAAAAAAA
AAAAAAAAAAAAAAAA
AAACAAAAAAAAAAAA
5,4,1,FF
7,5,1,FF
5,7,1,FF
