AABBBBBDDBBBBAAA
BBBBBBDADDBBBBAA
BBBBBDAADDDBBBBB
BBBBAAADADDBBBBB
BBBDADDDAADDDBBB
DDDAAAAADADDDDDD
DDDADDDDDDAADADA
DADADADDDDDDAAAA
BADAAADAADADADAB
BADAADDAAAADDDDB
BAADDDDDAADDADDB
BDADDDDDDDDDAABB
8,6,1,FH
2,6,2,S24
11,4,2,S24
7,7,1,IF
8,7,1,IF
5,3,2,S19
6,5,2,S19
5,10,2,S24
14,9,2,S24
14,7,2,S29
*8,7,AD
*7,7,AD
