AAAAABBBBBBBAAAA
ACAAABBBBBBBAACA
AAAABBBBCBBBBAAA
AAABBBBBBBBBBAAA
AAAAABCBBBBBAACA
AACAABBBBBBCAAAA
AAAAABBBCBBAAAAA
AAAABBBBBBBAAAAA
ACAABBBBBBBACAAB
AAAABBBBCBBAABBB
AAAABBBBBBAAABBB
AAAAABBBBBAABBBB
4,4,1,IF
13,6,1,FG
14,6,1,FG
4,1,2,S29
3,10,2,S29
3,9,2,S29
7,3,2,S13
12,5,2,S11
*4,4,AE
*14,6,AE
