FFCAAAAAAEEEEEAA
CCCAAAAAEEEEEEAA
FCAAAAAAAEEEEEEA
CAAAAAAAAAEEEEAA
AAAAAAAAAEEEEAAA
AAAAAAAAEEEEAAAA
AAAAAAAAAAAAAAAA
AAAAAAAAAAAAAAAA
AAAAAAAAAAAAAAAA
AAAAAAAAAAAAAAAA
AAAAAAAAAAAAAAAA
AAAAAAAAAAAAAAAA
4,6,1,FF
14,9,1,FF
7,8,1,FF
0,2,1,IM
6,4,2,S29
11,8,2,S29
4,9,2,S29
