AAAAAAAAAAAAAAAA
AAAAAAAAAAAAAAAA
AAAAAAAAAAAAAAAA
AAAAAAAAAAAAAAAA
AAAAAAAAAAAAAAAA
AAAAAAAAAAAAAAAA
AAAAAAAAAAAAAAAA
AAAAAAAAAAAAAAAA
CAAAAAAAAAAAAAAA
CCAAAAAAAAAAAAAA
FCCAAAAAAAAEEAAA
FFCAAAAAAAEEEEAA
