AAAAAAAAAAAAAAAA
DADAAAAAAADAAAAA
DCDCAADAAADDDBBB
DCCCDDDAAADBDDAB
AAAADAAAABDDADAA
DADDDAAAAAAADDAD
DDDAAAAAAADDADDD
DDDDAAADAADDDADD
DDDAAAAAADAADDAD
DADAAAAAAAAAAAAD
DDAAAABAAAAAADDD
DDAAAAAAAAAADDDD
4,6,1,FF
2,5,1,FF
3,8,1,FF
