CCCCCAAAAAAAAAAA
CCCCCAACAACCCCCA
CCCCCACCCBBBBBBB
CCCCCCABBBCBBBBB
CAAACCABBBAAAAAA
CCACCCCCGAACAAAA
CCAACACBBCAAAADD
CCAAAACCBCAACADD
ACAACABCCCACCADD
CACACCCCBBBCAADD
CEACABBCBBBCADDD
CCCCCCCCBBCADDDD
4,6,1,FF
2,5,1,FF
3,8,1,FF
