BEEEEEEEEEEEEEEE
BBEEEEEEEEEEEEEE
BBBAAAAEEEEEEEEE
AAAACAAEEEEEEEEE
AACAAAAAAEEEEEEE
AAAAACAAAAEEEEEE
ACAAAAACAAAAEEEE
AAAACAAAAAAAEEEE
AAAAAACAACAAAEEE
AACAAAAAAAACAAGG
AAAAAAAAAAAAAAAE
CCCCCCCEEEEEEEEE
1,1,2,S13
8,1,2,S14
12,2,2,S14
14,5,2,S14
10,4,2,S14
2,8,2,S19
4,10,2,S21
7,7,2,S21
