AAAAAAAAAAAAAAAC
ACCCACCCACCAAAAC
ACACACAAACACAAAC
ACCCACCCACACAAAC
ACCAACAAACACAAAC
ACACACCCACCAAAAC
AAAAAAAAAAAAAAAC
AACCCACCCACAAACD
AACAAACACAACDCDC
AACCCACACADDCDDC
AAAACACACDDCDCDC
AACCCDCCCDCDDDCD
10,3,1,IF
7,9,1,IF
2,2,1,IF
3,8,2,S19
3,4,2,S19
6,4,2,S19
6,2,2,S19
11,5,2,S19
11,1,2,S19
3,10,2,S19
*3,2,AB
*9,3,AB
*8,9,AB
