BBBBBBBBBBBBAAAA
BBBBBBBBBBBAAAAA
BBBBBBBBBBAAAAAA
BBBBBBBBAAAAAAAA
BBBBBBBBAAAAAAAA
BBBBBBBAAAAAAAAA
BBBBBBAAAAAAAAAA
BBBBBAAAAAAAAAAA
BBBAAAAAAAAAAAAC
BBAAAAAAAAAAAAFC
BAAAAAAAAAAAACFF
AAAAAAAAAAAACCCC
