CAAAAAAAAAAAAAAA
CFFFAFFFAFFFAFFF
CAFAAFAAAFAFAFAF
CFAAAFFFAFFFAFAF
CFAAAFAAAFFAAFAF
CAFFAFFFAFAFAFFF
CAAAAAAAAAAAAAAA
CAAAAFAAACCCAAAA
CFAAFFAFACACFAAB
CAFFFAAFACCCFABB
CAFFFAAFAAAAFABB
CFFAFFFFFAAFBBBB
7,6,2,S19
3,8,2,S19
13,6,2,S19
10,4,2,S19
*9,8,AB
