DDDDDDDDDDDAAAAC
DDDDDDDDDAAAAAAA
DDDDCDDDAAAAAAAB
DDDDDDDAAAAAAABB
DDDDDDAAAAABBBBB
DCDDAAAAAAAGGGGG
DDDAAAAAAABBBBBB
DDAAAAAAAABBBBBB
DAAAAAAAABBBBBBB
DAAAAAAABBBBBBBB
DAAAAAABBBBBBBBB
DAAAAABBBBBBBBBB
11,2,1,FF
7,5,1,FF
5,8,1,FF
5,1,2,S24
2,3,2,S24
7,7,2,S29
9,3,2,S29
3,10,2,S29
