CCCCCAAAAAAAAAAA
CCCCCAAAAAAAAAAA
CCCCCAABBBBBBBBB
CCCCCAABBBBBBBBB
AAAAAAABBAAAAAAA
AAAAAAAGGAAAAAAA
AAAAAAABBAAAAADD
AAAAAAABBAAAAADD
AAAAAABBBBAAAADD
AAAAABBBBBBAAADD
EEAAABBBBBBAADDD
EEAAAABBBBAADDDD
4,6,1,FF
2,5,1,FF
3,8,1,FF
4,6,1,FF
2,5,1,FF
3,8,1,FF
4,6,1,FF
2,5,1,FF
3,8,1,FF
4,6,1,FF
2,5,1,FF
3,8,1,FF
4,6,1,FF
2,5,1,FF
3,8,1,FF
4,6,1,FF
2,5,1,FF
3,8,1,FF
4,6,1,FF
2,5,1,FF
3,8,1,FF
4,6,1,FF
2,5,1,FF
3,8,1,FF
4,6,1,FF
2,5,1,FF
3,8,1,FF
4,6,1,FF
2,5,1,FF
3,8,1,FF
4,6,1,FF
2,5,1,FF
3,8,1,FF
4,6,1,FF
2,5,1,FF
3,8,1,FF
4,6,1,FF
2,5,1,FF
3,8,1,FF
4,6,1,FF
2,5,1,FF
3,8,1,FF
4,6,1,FF
2,5,1,FF
3,8,1,FF
