CCCCCAAAAAAAAAAA
CCCCCAAAAAAAAAAA
CCCCCAABBBBBBBBB
CCCCCAABBBBBBBBB
AAAAAAABBBAAAAAA
AAAAAAAGGAAAAAAA
AAAAAAABBAAAAADD
AAAAAAABBAAAAADD
AAAAAABBBBAAAADD
AAAAABBBBBBAAADD
EEAAABBBBBBAADDD
EEAAAABBBBAADDDD
