AAAAABBBBBABBBBB
AAAAABBBBBABBBBB
AAAAABBBBBBBBBBB
AAAAABBBBBBBBBBB
AAAABBBBBBBBBBBB
AAAABBBBBBBBBBBB
AAAABBBBBBBBBBBB
AAAABBBBBBBBBBBB
AAAABBBBBBBBBBBB
AAAABBBBBBBBBBBB
AAAABBBBBBBBBBBB
AAABBBBBBBBBBBBA
8,5,2,S13
13,7,2,S13
8,8,2,S13
11,5,2,S13
11,9,2,S13
