DDDDDDDDEEEEEEDD
DDDDDDDDEEEEEEDA
DDCDDDDDEEEEEEDA
DDDDDDDDDDEEEEDA
DDDDCDDFDDDEEEED
DDDDDDDDDDDEEEED
DDFDDDDDDDDDEEEE
DDDDDDDCDDDDEEEE
DDDDCDDDDDDDEEEE
DDDDDDDDDFDDDDEE
DDDDDDDDDDDDDDDD
CCCCCCCCCCCCCCCC
11,2,2,S14
13,6,2,S14
5,6,2,S16
