AAAAAAAACCBBBBBB
AAAAAACAAABBBBBB
AAAACAAAABBBBBBB
AAAAAAAABBBBBBBB
AAAAAABBBBBBBBBB
AACAABBGGGGGGGGB
AAABBBBBBBBBBBGB
AABBBBBBBBBBBBGB
ABBBBBBBBBBBBBBA
BBBBBBBBBBBBBBAA
BBBBBBBBBBBBBAAA
BBBBBBBBBBBBBAAA
3,3,1,FG
4,3,1,FH
1,10,2,S13
7,6,2,S13
4,8,2,S13
*14,8,AA
*5,5,AA
*6,5,AA
