CCCCCADDAAAAAAAA
DDDCCDDADDDAAAAA
DCDCDADDDBDDDBBB
DCCCDDDBDBDBDDBB
AAAADDABBBDDADAA
DADDDADDDAAADDDD
DDDADADDDDDDADDD
DDDDDDDDBADDDADD
DDDAADBDDDDDDDDD
DADDADBDDDDDDADD
DDAAADBDBBBAADDD
DDAAADBBBBAADDDD
4,6,1,FF
2,5,1,FF
3,8,1,FF
